WWWWWW   
WP...W 
W WW.W   
WIB..W
WWWWWW 
