WWWWWWWWWWWWWWWWWWWWWWWWWWW
WI B Y C I B Y C I B Y C .W
WWWWWWWWWWWWWWWWWWWWWWWWW.WWW
W.......................P...W
WWWWWWWWWWWWWWWWWWWWWWWWWWWWW

