
   WWWWWWWWWWWWWW  
   W............W
   WYWWWWWWWWWW.W 
WWWW.WWWWWWWWWW.W  
W.....C......WW.W  
W.WW.WWWWWWW.WW.W 
W.WW.W     W.WW.W  
W.WW.WWWWWWW.WW.WWWWW  
W.WW.WW.............W
W.WW.WW.WWWW.WW.WWW.W 
W.WW.WW.W  W.WW.W W.W  
W.WW.WW.W  WIWW.W W.W
W.WW.WW.W  W.WW.W W.W 
W.WW.WW.W  W.WW.W W.W  
W.WW.WW.WWWW.WW.W W.W
W............WW.W W.W  
WWWW.WWBWWWWWWW.W W.W  
   W.WW.W     W.W W.W 
   W.WW.WWWWWWW.WWW.W  
   W..............P.W
   WWWWWWWWWWWWWWWWWW
  
  