WWWWWWWWWWWWWWWWWWWWWWWWWWWWWWWWWWWWWWWWWWWWWWWWWWWWWWWWWWWWWWWWWWWWWWWWWWWWWWWW
W..P                                                                           W
WWWWWWWWWWWWWWWWWWWWWWWWWWWWWWWWWWWWWWWWWWWWWWWWWWWWWWWWWWWWWWWWWWWWWWWWWWWWWW W
W                                                                              W
W WWWWWWWWWWWWWWWWWWWWWWWWWWWWWWWWWWWWWWWWWWWWWWWWWWWWWWWWWWWWWWWWWWWWWWWWWWWWWW
WBYBYYCIYBBYBYCBBBIIIIIYCYIYICBYBYYBBBBBBIBYYYIYYYCCCIYIIYBIBCYYBIIIYCBIIICYYCCW
WYICYCIBIIBBBBBBYBYBCBCICICYYBCIYCBYIBYYYCYCYCICIBBCCCIBIICCCCCBYYCBCIBYIIYCCIYW
WBIBBICCIBCIBIIBBYIYBCYYYYICIBCIYYCBIYBCBCYYYYICCIBIYYBYYCCBCYYIIIIYCBCIIIBYCIBW
WCYIYBCCIIYBICYCYYIBBCBYCYCIIIYICICIIBYIICCICIIBIBCBBBIBBICIBYCYYIYCYIBIBCICBYYW
WIBBBBCYIBBIBCIBBCICBIYCYCICIBYYBCYYIIYIBBBIBCCIIIYICICBBCBIBYBYYCCIIYBYCBBBYICW
WCBCBBIYIYYIBIIIIYIYYYYYCBYICCIICIICCCCIIBBYCBCCYCBICYBICIBBCYBIYYIYYCCBBYBICCCW
WCCCCYYYIYBYCIIYYBBIBYCBICCBYCYCYICIIIBYICBCICYICCCIIBIBCYYIYBBCYCIIYBYBYYCBCYCW
WBCYCBCICIICIBBCBBYCBBCBCYCBICYIBBYBYIBBBBYBBBYCCYYIBBIIYCYBCBYBBYCCCBBBYCIBCYIW
WIYCBYBIYCBCCIIBYYBICBICYYIYIYBBCBICICIYBYCBIBYBCIIBBIYICCIBYYYBCIIICCYBIYIYBIIW
WYCCYCYCIBBYYYCIIYCIICBYBBYIBIBCCIIYYYBIYYCIYYBCYBBIBBCBBIBYYCICBCBIIIIIICBYBICW
WWWWWWWWWWWWWWWWWWWWWWWWWWWWWWWWWWWWWWWWWWWWWWWWWWWWWWWWWWWWWWWWWWWWWWWWWWWWWWWW
