WWWWWWWWWWWWWWWWWWWWWWWWWWWWWWW
W.............................W
W..W.......................W..W
W..W.......................W..W
W..W.............I.........W..W
W..W.......................W..W
W..WWWWWWWWWWWWWWWWWWWWWWWWW..W
W..W.......................W..W
W..W......P................W..W
W..W.......................W..W
W..W.......................W..W
W.............................W
W.............................W
WWWWWWWWWWWWWWWWWWWWWWWWWWWWWWW
 
